 # # ###  #A
 # #   # ## 
   # #   ##
# ## # # ## 
#    # #    
### ## #####
B   ##      
